WWWWWWWWWWWWWWWWWWWWWWWWWWWWWWWWWWWWWWWWWWWWWWWWWWWWWWWWWWWW
W  WW WE WWWWW   WWWWW BB   WWW   E  W  D   B    WW   D    W
W WWWWWW WWWWW W WWWWW WWWW W WW W WWW WWWWW WWWWW WWWWWW  W
W W    W W  D  W    B    W  W W  W      W   W      W      W W
W WWWW W WWWWW WWWWWWWWW W W W WWWW WWW W W WWWW W W WW WW W
W W    W      W W      W W W W    W W   W W     W W W  W  W
W WWWW WWWWWW W W WWWW W W W WWWW W WWWWW WWWW W W WWWW WW W
W      W    W W W W    W W W    W W      W   W W W W     W W
WWWW WWWW WW W W W WW WW W W WWWW WWWWWW W W W W W WWW WWW W
W    W    W  W   W   W  W   W    W      W W W   W   W     W
W WWWWW WWWWWWWWWWWWW W WWWWWWWWWWWWWWWWW W WWWWWWWWWWWWW W
W W    W      W     W W W      D    B   W W W      B    W  W
W W WWWWWWWWW W WWW W W W WWWWWWWWWWWW W W W WWWWWWWWWWWW WW
W W          W W    W W W         W    W W W W              W
W WWWWWWWWWWWWW WWWWW W WWWWWWWWW W WWWWW W W WWWWWWWWWWWWW W
W W      D     W      W W     B    W     W W      E       W W
W WWW WWWWWWWW WWWWWWWW WWWWWWWWWW WWWWWWWW WWWWWW WWWWWW W W
W   W W      W        W W        W W      W W      W    W W
WWW W W WWWW W WWWWWW W W WWWWWW W W WWWW W W WWWWWW WW W W
W   W W      W      B W W      W W W    W W W      W  W  W
W WWWWWWWWWWWWWWWWWWWWWWWWWWWWWWWWWWWWWWWWWWWWWWWW W W  W W
W     B    W      D       B      E      D      B    W W  W W
W WWWWWWW W WWWW WWWWWWW WWWWWWWWWWWW WWWWWW WWWWW W W  W W
W      K    B      C       K      B      C      K     D    W
WWWWWWWWWWWWWWWWWWWWWWWWWWWWWWWWWWWWWWWWWWWWWWWWWWWWWWWWWWWW
