WWWWWWWWWWWWWWWWWWWWWWWWWWWWWWWWWWWWWWWWWWWWWWWWWWWWWWWWWWWW
W    D    B         D                                D     W
W E   WWW      D       WWW    B       E       WWW          W
W   WW   B      WW   D     W          W     D     W        W
W    D       WWW      B     WWW      B        WW   D       W
W        WWWW       D      WWWW                 WWW        W
WB      D      K        B      D      B     D      B       W
W    WWW    WWW     WWW     WWW     WWW    WWW    WWW      W
W   D    B             D       B       K      D      B     W
W      WWWWWW        WWWWWW        WWWWWW        WWWWWW    W
W  B       D      K      B  J   D      B      D      B     W
W    WWWWWWWWWWWW   WWWWWWWWWWWWW   WWWWWWWWWWWW    WWWWW  W
W       B    D    B               D    B    D    B         W
W    WWWWWW    WWWW      WWWW      WWWW     WWWW    WWW    W
W  D      B    D    B       D      B     D     B     D     W
W       WWW   K    WWW   E   WWW        WWW      WWW       W
W B      D     B      D      B      D      B      D        W
W   WWWWWW    WWWWWW   WWWWWW   WWWWWW   WWWWWW    WWWWW   W
W D      B  D      B    D      B     D      B     D      D W
W    WWW    WWW     WWW     WWW     WWW    WWW    WWW    W W
W E       D             B       D      B       D       B   W
W   WWWW    WWWW      WWWW      WWWW     WWWW    WWWW      W
W      B      D      B      E      D      B      D      B  W
W          D      B        K      D       B       D      B W
WWWWWWWWWWWWWWWWWWWWWWWWWWWWWWWWWWWWWWWWWWWWWWWWWWWWWWWWWWWW