WWWWWWWWWWWWWWWWWWWWWWWWWWWWWWWWWWWWWWWWWWWWWWWWWWWWWWWWWWWW
W       D       B     D                    D         B     W
W D   WWW   K       D     WWW    E     B      WWW          W
W   WW     B    WW    D       W     D     WW       W       W
W    B       WWW     D     WWWW        B      WW     D     W
W      WWWW       B       WWWW     D           WWW         W
W D   E   B   K        B      D     B    D     B       B   W
W    WWW    WWW     WWW     WWW     WWW    WWW    WWW      W
W B     D         B      D           B     D         D     W
W WWWWWW        WWWWWW        WWWWWW        WWWWWW         W
W   B     D      K     B  J      D     B       D      B    W
W  WWWWWWWWWWWW   WWWWWWWWWWWWW   WWWWWWWWWWWW    WWWWW    W
W     B     D   B              D     B    D     B          W
W WWWWWW     WWWW     WWWW       WWWW     WWWW     WWW     W
W B     D     B     D      B     D     B     D     B       W
W     WWW   K    WWW   E   WWW       WWW     WWW     E     W
W D     B     D     B     D      B     D     B     D       W
W   WWWWWW    WWWWWW   WWWWWW   WWWWWW   WWWWWW    WWWWW   W
W B     D     B     D     B     D     B     D     B     D  W
W   WWW    WWW    WWW     WWW     WWW    WWW    WWW     W  W
W D        B     D      B     D        B       D      B    W
W WWWW     WWWW      WWWW     WWWW     WWWW     WWWW       W
W   B    D     B      E     D      B     D     B     D     W
W     D     B      K       D     B       D     B     D     W
WWWWWWWWWWWWWWWWWWWWWWWWWWWWWWWWWWWWWWWWWWWWWWWWWWWWWWWWWWWW

